111111000100
110001001110
111011101010
011110111110
010010000000
011111111111
010100100101
010100111111
110111101001
100110111111
101011011000
111001111111