100100011111
111111110001
101001010001
011111111100
100100100110
111100000000
100110111100
100011100111
111111010001
001001111100
001000100100
111100111111