111111111110
100001010010
11101111110
101000001010
111111001110
100101000010
100111111111
111001001010
101001001111
111111111011
000101001010
000111111011